Time,Offset,Name
1901-12-13T20:45:52,-05:17,SMT
1910-01-10T04:42:45,-05:00,-05
1916-07-01T05:00:00,-05:17,SMT
1918-09-10T04:42:45,-04:00,-04
1919-07-01T04:00:00,-05:17,SMT
1927-09-01T04:42:45,-04:00,-04
1928-04-01T04:00:00,-05:00,-05
1928-09-01T05:00:00,-04:00,-04
1929-04-01T04:00:00,-05:00,-05
1929-09-01T05:00:00,-04:00,-04
1930-04-01T04:00:00,-05:00,-05
1930-09-01T05:00:00,-04:00,-04
1931-04-01T04:00:00,-05:00,-05
1931-09-01T05:00:00,-04:00,-04
1932-04-01T04:00:00,-05:00,-05
1932-09-01T05:00:00,-04:00,-04
1942-06-01T04:00:00,-05:00,-05
1942-08-01T05:00:00,-04:00,-04
1946-08-29T04:00:00,-04:00,-04
1947-04-01T04:00:00,-05:00,-05
1947-05-22T04:00:00,-04:00,-04
1968-11-03T04:00:00,-03:00,-03
1969-03-30T03:00:00,-04:00,-04
1969-11-23T04:00:00,-03:00,-03
1970-03-29T03:00:00,-04:00,-04
1970-10-11T04:00:00,-03:00,-03
1971-03-14T03:00:00,-04:00,-04
1971-10-10T04:00:00,-03:00,-03
1972-03-12T03:00:00,-04:00,-04
1972-10-15T04:00:00,-03:00,-03
1973-03-11T03:00:00,-04:00,-04
1973-09-30T04:00:00,-03:00,-03
1974-03-10T03:00:00,-04:00,-04
1974-10-13T04:00:00,-03:00,-03
1975-03-09T03:00:00,-04:00,-04
1975-10-12T04:00:00,-03:00,-03
1976-03-14T03:00:00,-04:00,-04
1976-10-10T04:00:00,-03:00,-03
1977-03-13T03:00:00,-04:00,-04
1977-10-09T04:00:00,-03:00,-03
1978-03-12T03:00:00,-04:00,-04
1978-10-15T04:00:00,-03:00,-03
1979-03-11T03:00:00,-04:00,-04
1979-10-14T04:00:00,-03:00,-03
1980-03-09T03:00:00,-04:00,-04
1980-10-12T04:00:00,-03:00,-03
1981-03-15T03:00:00,-04:00,-04
1981-10-11T04:00:00,-03:00,-03
1982-03-14T03:00:00,-04:00,-04
1982-10-10T04:00:00,-03:00,-03
1983-03-13T03:00:00,-04:00,-04
1983-10-09T04:00:00,-03:00,-03
1984-03-11T03:00:00,-04:00,-04
1984-10-14T04:00:00,-03:00,-03
1985-03-10T03:00:00,-04:00,-04
1985-10-13T04:00:00,-03:00,-03
1986-03-09T03:00:00,-04:00,-04
1986-10-12T04:00:00,-03:00,-03
1987-04-12T03:00:00,-04:00,-04
1987-10-11T04:00:00,-03:00,-03
1988-03-13T03:00:00,-04:00,-04
1988-10-09T04:00:00,-03:00,-03
1989-03-12T03:00:00,-04:00,-04
1989-10-15T04:00:00,-03:00,-03
1990-03-11T03:00:00,-04:00,-04
1990-09-16T04:00:00,-03:00,-03
1991-03-10T03:00:00,-04:00,-04
1991-10-13T04:00:00,-03:00,-03
1992-03-15T03:00:00,-04:00,-04
1992-10-11T04:00:00,-03:00,-03
1993-03-14T03:00:00,-04:00,-04
1993-10-10T04:00:00,-03:00,-03
1994-03-13T03:00:00,-04:00,-04
1994-10-09T04:00:00,-03:00,-03
1995-03-12T03:00:00,-04:00,-04
1995-10-15T04:00:00,-03:00,-03
1996-03-10T03:00:00,-04:00,-04
1996-10-13T04:00:00,-03:00,-03
1997-03-30T03:00:00,-04:00,-04
1997-10-12T04:00:00,-03:00,-03
1998-03-15T03:00:00,-04:00,-04
1998-09-27T04:00:00,-03:00,-03
1999-04-04T03:00:00,-04:00,-04
1999-10-10T04:00:00,-03:00,-03
2000-03-12T03:00:00,-04:00,-04
2000-10-15T04:00:00,-03:00,-03
2001-03-11T03:00:00,-04:00,-04
2001-10-14T04:00:00,-03:00,-03
2002-03-10T03:00:00,-04:00,-04
2002-10-13T04:00:00,-03:00,-03
2003-03-09T03:00:00,-04:00,-04
2003-10-12T04:00:00,-03:00,-03
2004-03-14T03:00:00,-04:00,-04
2004-10-10T04:00:00,-03:00,-03
2005-03-13T03:00:00,-04:00,-04
2005-10-09T04:00:00,-03:00,-03
2006-03-12T03:00:00,-04:00,-04
2006-10-15T04:00:00,-03:00,-03
2007-03-11T03:00:00,-04:00,-04
2007-10-14T04:00:00,-03:00,-03
2008-03-30T03:00:00,-04:00,-04
2008-10-12T04:00:00,-03:00,-03
2009-03-15T03:00:00,-04:00,-04
2009-10-11T04:00:00,-03:00,-03
2010-04-04T03:00:00,-04:00,-04
2010-10-10T04:00:00,-03:00,-03
2011-05-08T03:00:00,-04:00,-04
2011-08-21T04:00:00,-03:00,-03
2012-04-29T03:00:00,-04:00,-04
2012-09-02T04:00:00,-03:00,-03
2013-04-28T03:00:00,-04:00,-04
2013-09-08T04:00:00,-03:00,-03
2014-04-27T03:00:00,-04:00,-04
2014-09-07T04:00:00,-03:00,-03
2016-05-15T03:00:00,-04:00,-04
2016-08-14T04:00:00,-03:00,-03
2016-12-04T03:00:00,-03:00,-03
